***XXXXXXXXXXXX
*X*XXX****XXXXX
XX*****XX*XXXXX
XXXXXX*X****XXX
X****X*XX*X*XXX
XXXXXXXXX******