##########
#        #
#    P   #
#    X   #
#    O   #
#   XO   #
#        #
##########